School Name,Acceptance Rate,SAT Math,SAT Reading and Writing,SAT Composite,ACT Composite,URL
California Institute of Technology,6.40%,795,750,1545,36,http://caltech.edu
Massachusetts Institute of Technology,6.70%,790,745,1535,35,http://mit.edu
Harvey Mudd College,14.50%,790,740,1530,35,http://hmc.edu
Harvard University,4.70%,770,750,1520,34,http://harvard.edu
University of Chicago,7.30%,775,745,1520,34,http://uchicago.edu
Washington University in Saint Louis,15.00%,780,740,1520,34,http://wustl.edu
Yale University,6.10%,770,745,1515,34,http://yale.edu
Carnegie Mellon University,15.40%,780,730,1510,34,http://cmu.edu
Duke University,8.90%,770,740,1510,34,http://duke.edu
Johns Hopkins University,11.50%,770,735,1505,34,http://jhu.edu
Stanford University,4.30%,770,735,1505,34,http://stanford.edu
Columbia University in the City of New York,5.90%,770,735,1505,34,http://columbia.edu
Rice University,11.10%,775,730,1505,34,http://rice.edu
Vanderbilt University,9.60%,775,730,1505,34,http://vanderbilt.edu
Princeton University,5.50%,765,740,1505,34,http://princeton.edu
Franklin W. Olin College of Engineering,15.70%,770,731,1501,34,http://olin.edu
University of Pennsylvania,8.40%,770,730,1500,34,http://upenn.edu
Dartmouth College,7.90%,760,740,1500,34,http://dartmouth.edu
Northwestern University,9.10%,765,730,1495,34,http://northwestern.edu
Brown University,7.70%,755,730,1485,34,http://brown.edu
Cornell University,10.90%,760,720,1480,34,http://cornell.edu
Amherst College,11.30%,755,725,1480,33,http://amherst.edu
Williams College,13.00%,750,729,1479,33,http://williams.edu
University of Notre Dame,17.70%,750,725,1475,34,http://nd.edu
Swarthmore College,9.50%,750,720,1470,32,http://swarthmor.edu
Northeastern University,18.10%,750,715,1465,34,http://northeastern.edu
Pomona College,7.40%,745,720,1465,34,http://pomona.edu
Tufts University,15.00%,750,715,1465,33,http://tufts.edu
Georgia Institute of Technology,22.60%,750,715,1465,33,http://gatech.edu
Grinnell College,24.40%,750,710,1460,32,http://grinnell.edu
Georgetown University,14.50%,735,715,1450,33,http://georgetown.edu
Carleton College,19.00%,740,710,1450,33,http://carleton.edu
Haverford College,18.80%,740,710,1450,33,http://haverford.edu
Middlebury College,15.40%,735,710,1445,33,http://middlebury.edu
Hamilton College,21.30%,730,710,1440,33,http://hamilton.edu
University of Southern California,13.00%,740,700,1440,32,http://usc.edu
Vassar College,24.60%,730,710,1440,32,http://vassar.edu
New York University,16.20%,740,700,1440,32,http://nyu.edu
University of Michigan at Ann Arbor,22.90%,735,700,1435,33,http://umich.edu
Emory University,18.50%,740,695,1435,33,http://emory.edu
Case Western Reserve University,29.30%,745,690,1435,32,http://case.edu
Smith College,31.00%,720,710,1430,32,http://smith.edu
University of Virginia,23.90%,725,705,1430,32,http://virginia.edu
Colby College,13.10%,730,700,1430,32,http://colby.edu
Claremont McKenna College,9.30%,730,697,1427,32,http://cmc.edu
Wellesley College,19.50%,720,705,1425,32,http://wellesley.edu
Boston College,27.20%,725,695,1420,33,http://bc.edu
Boston University,22.10%,730,690,1420,32,http://bu.edu
Washington and Lee University,21.20%,720,700,1420,32,http://wlu.edu
Tulane University,17.30%,720,700,1420,32,http://tulane.edu
Reed College,35.00%,710,710,1420,32,http://reed.edu
University of Rochester,31.40%,750,670,1420,31,http://rochester.edu
Colgate University,24.90%,725,690,1415,33,http://colgate.edu
The College of William and Mary,37.70%,715,700,1415,32,http://wm.edu
Berkeley University of California,14.80%,725,690,1415,31,http://berkeley.edu
The Cooper Union,13.10%,730,683,1413,31,http://cooper.edu
Macalester College,41.20%,720,691,1411,30,http://macalester.edu
Bryn Mawr College,34.10%,710,700,1410,31,http://brynmawr.edu
Pitzer College,13.30%,720,690,1410,31,http://pitzer.edu
The Jewish Theological Seminary,59.70%,690,720,1410,29,http://jtsa.edu
Rensselaer Polytechnic Institute,43.00%,731,678,1409,31,http://rpi.edu
Bowdoin College,10.30%,710,695,1405,32,http://bowdoin.edu
Stevens Institute of Technology,41.40%,730,675,1405,32,http://stevens.edu
University of California Los Angeles,12.30%,715,690,1405,31,http://ucla.edu
Barnard College,13.90%,700,704,1404,31,http://barnard.edu
Mount Holyoke College,50.90%,720,680,1400,31,http://mtholyoke.edu
Brandeis University,31.10%,720,680,1400,31,http://brandeis.edu
Villanova University,28.20%,715,680,1395,33,http://villanova.edu
Wesleyan University,16.30%,700,695,1395,32,http://wesleyan.edu
University of North Carolina,22.60%,705,690,1395,30,http://northcarolina.edu
University of North Carolina at Chapel Hill,22.60%,705,690,1395,30,http://unc.edu
Scripps College,24.20%,690,700,1390,32,http://scrippscollege.edu
Wake Forest University,29.40%,710,680,1390,31,http://wfu.edu
Southern Methodist University,47.30%,710,680,1390,31,http://smu.edu
University of Wisconsin Madison,51.70%,725,665,1390,30,http://wisc.edu
Colorado College,15.00%,700,685,1385,31,http://coloradocollege.edu
Kenyon College,35.80%,690,690,1380,31,http://kenyon.edu
University of Maryland,44.10%,705,675,1380,31,http://umaryland.edu
Bates College,17.80%,700,680,1380,31,http://bates.edu
Trinity College,33.50%,710,670,1380,31,http://trincoll.edu
Worcester Polytechnic Institute,41.60%,710,670,1380,31,http://wpi.edu
University of Richmond,30.20%,700,675,1375,32,http://richmond.edu
Binghamton University,39.80%,695,680,1375,30,http://binghamton.edu
Davidson College,19.50%,690,682,1372,31,http://davidson.edu
The George Washington University,41.90%,690,680,1370,31,http://gwu.edu
Occidental College,37.30%,690,680,1370,30,http://oxy.edu
Babson College,24.40%,710,660,1370,30,http://babson.edu
Lehigh University,32.10%,710,655,1365,31,http://lehigh.edu
Hillsdale College,36.00%,670,693,1363,31,http://hillsdale.edu
Santa Clara University,48.80%,695,665,1360,30,http://scu.edu
Franklin & Marshall College,35.30%,700,660,1360,30,http://fandm.edu
Colorado School of Mines,53.10%,695,665,1360,30,http://mines.edu
University of California San Diego,30.20%,700,660,1360,30,http://ucsd.edu
University of Florida,38.80%,685,675,1360,30,http://ufl.edu
Connecticut College,37.80%,680,678,1358,30,http://conncoll.edu
Rose-Hulman Institute of Technology,60.90%,710,647,1357,30,http://rose-hulman.edu
University of Miami,27.10%,690,665,1355,31,http://miami.edu
Ohio State University,53.70%,710,645,1355,30,http://osu.edu
Ohio State University,53.70%,710,645,1355,30,http://osu.edu
University of Texas at Austin,31.80%,685,670,1355,30,http://utexas.edu
University of California Santa Barbara,32.20%,690,665,1355,29,http://ucsb.edu
University of Minnesota,56.70%,703,649,1352,28,http://umn.edu
University of Pittsburgh,56.70%,685,665,1350,31,http://pitt.edu
Trinity University,34.20%,680,670,1350,30,http://trinity.edu
Union College,38.70%,690,660,1350,30,http://union.edu
University of Texas Dallas,78.60%,690,660,1350,30,http://utdallas.edu
University of Illinois at Urbana-Champaign,62.20%,700,650,1350,29,http://illinois.edu
College of the Holy Cross,34.20%,680,665,1345,30,http://holycross.edu
Holy Cross College,34.20%,680,665,1345,30,http://hcc-nd.edu
University of Washington,48.70%,690,650,1340,30,http://uw.edu
University of Washington,48.70%,690,650,1340,30,http://washington.edu
Fordham University,45.80%,680,660,1340,30,http://fordham.edu
Lawrence University,62.50%,670,670,1340,29,http://lawrence.edu
Bennington College,56.60%,640,700,1340,29,http://bennington.edu
Gettysburg College,45.40%,670,670,1340,28,http://gettysburg.edu
Illinois Institute of Technology,52.70%,710,630,1340,28,http://iit.edu
Bucknell University,33.00%,680,657,1337,30,http://bucknell.edu
North Carolina State University,44.90%,680,655,1335,30,http://ncsu.edu
California Polytechnic State University,30.20%,675,660,1335,29,http://calpoly.edu
Stony Brook University,44.10%,695,640,1335,29,http://stonybrook.edu
Bentley University,43.20%,690,641,1331,30,http://bentley.edu
Sarah Lawrence College,55.80%,650,681,1331,29,http://slc.edu
Saint John’s College (MD),57.60%,650,680,1330,29,http://sjc.edu
Rhodes College,44.60%,660,670,1330,29,http://rhodes.edu
Bard College,64.60%,650,680,1330,29,http://bard.edu
Lafayette College,31.50%,665,660,1325,31,http://lafayette.edu
University of Georgia,48.60%,660,665,1325,30,http://uga.edu
New College of Florida,76.80%,650,674,1324,29,http://ncf.edu
Pepperdine University,35.70%,670,650,1320,29,http://pepperdine.edu
Wheaton College,82.60%,665,650,1315,29,http://wheaton.edu
University of Connecticut,48.80%,670,645,1315,29,http://uconn.edu
Brigham Young University,67.50%,655,660,1315,29,http://byu.edu
Purdue University,59.80%,675,640,1315,29,http://purdue.edu
Clemson University,47.00%,660,650,1310,30,http://clemson.edu
Miami University,83.80%,670,640,1310,29,http://miamioh.edu
University of California Irvine,28.80%,675,635,1310,29,http://uci.edu
Rhose Island School of Design,23.90%,665,645,1310,29,http://risd.edu
Skidmore College,26.90%,660,650,1310,29,http://skidmore.edu
Hobart and William Smith Colleges,61.10%,650,660,1310,28,http://hws.edu
Illinois Wesleyan University,60.90%,690,620,1310,27,http://iwu.edu
Yeshiva University,80.50%,640,670,1310,27,http://yu.edu
New Mexico Institute of Mining and Technology,23.20%,670,640,1310,26,http://nmt.edu
Furman University,61.10%,650,659,1309,29,http://furman.edu
Soka University of America,39.00%,680,625,1305,27,http://soka.edu
Dickinson College,49.10%,650,653,1303,29,http://dickinson.edu
Lewis and Clark College,73.80%,640,663,1303,28,http://lclark.edu
Denison University,33.90%,660,640,1300,30,http://denison.edu
Rochester Institute of Technology,66.00%,665,635,1300,30,http://rit.edu
Centre College,76.30%,660,640,1300,29,http://centre.edu
University of Tulsa,40.80%,650,650,1300,29,http://utulsa.edu
Emerson College,35.60%,650,650,1300,29,http://emerson.edu
American University,31.50%,635,665,1300,29,http://american.edu
Saint Olaf College,49.90%,650,650,1300,29,http://stolaf.edu
Arizona Western College,100.00%,650,650,1300,28,http://azwestern.edu
Rutgers University,60.10%,665,635,1300,28,http://rutgers.edu
Pratt Institute,48.70%,665,635,1300,28,http://pratt.edu
Loyola Marymount University,47.10%,650,646,1296,29,http://lmu.edu
Clark University,59.40%,640,653,1293,30,http://clarku.edu
Baylor University,45.30%,652,641,1293,26,http://baylor.edu
University of Massachusetts Amherst,63.80%,655,635,1290,29,http://umass.edu
Drexel University,74.70%,655,635,1290,28,http://drexel.edu
Hampshire College,62.80%,610,680,1290,27,http://hampshire.edu
New Jersey Institute of Technology,63.70%,660,630,1290,27,http://njit.edu
University of  Maryland Baltimore County,57.90%,640,650,1290,27,http://umbc.edu
Sewanee The University of the South,65.20%,640,646,1286,28,http://sewanee.edu
University of California Santa Cruz,47.70%,655,630,1285,28,http://ucsc.edu
Virginia Polytechnic Institute and State University,64.80%,650,635,1285,28,http://vt.edu
Providence College,47.50%,640,640,1280,29,http://providence.edu
University of San Diego,48.70%,640,640,1280,29,http://sandiego.edu
University of California Davis,41.20%,660,620,1280,28,http://ucdavis.edu
Chapman University,53.60%,640,640,1280,28,http://chapman.edu
University of the Virgin Islands,98.40%,640,640,1280,27,http://uvi.edu
Saint Lawrence University,48.30%,630,648,1278,28,http://stlawu.edu
Texas A&M University,57.50%,645,630,1275,29,http://tamu.edu
Syracuse University,49.90%,645,630,1275,28,http://syr.edu
University of South Carolina,68.60%,635,640,1275,28,http://sc.edu
Saint Louis University,57.50%,640,634,1274,28,http://slu.edu
DigiPen Institute of Technology,57.00%,630,642,1272,27,http://digipen.edu
University of Denver,56.50%,630,640,1270,29,http://du.edu
University of Vermont,67.30%,630,640,1270,29,http://uvm.edu
Wofford College,63.60%,630,640,1270,29,http://wofford.edu
Florida State University,36.00%,630,640,1270,28,http://fsu.edu
University of Alabama in Huntsville,76.30%,630,640,1270,28,http://uah.edu
Earlham College,51.90%,640,630,1270,28,http://earlham.edu
Fairfield University,60.30%,640,630,1270,28,http://fairfield.edu
Kettering University,70.30%,650,620,1270,27,http://kettering.edu
College of the Atlantic,67.90%,600,669,1269,28,http://coa.edu
The College of Wooster,56.40%,640,628,1268,27,http://wooster.edu
Penn State University,49.10%,640,625,1265,28,http://psu.edu
University of Cincinnati,73.10%,640,625,1265,27,http://uc.edu
Calvin College,79.00%,640,625,1265,27,http://calvin.edu
University of Saint Thomas,81.90%,640,625,1265,26,http://stthom.edu
University of Saint Thomas,81.90%,640,625,1265,26,http://stthomas.edu
Mercer University,73.30%,630,633,1263,27,http://mercer.edu
Gonzaga University,65.60%,630,632,1262,28,http://gonzaga.edu
University of Utah,62.10%,635,627,1262,26,http://utah.edu
United States Naval Academy,8.50%,640,620,1260,29,http://usna.edu
The College of New Jersey,49.30%,635,625,1260,28,http://tcnj.edu
University of Delaware,62.40%,630,630,1260,28,http://udel.edu
Kalamazoo College,72.80%,620,640,1260,28,http://kzoo.edu
Clarkson University,71.10%,640,620,1260,27,http://clarkson.edu
Hendrix College,79.80%,640,620,1260,27,http://hendrix.edu
Milwaukee School of Engineering,62.80%,660,600,1260,27,http://msoe.edu
University of Portland,61.90%,620,640,1260,27,http://up.edu
University of the Sciences in Philadelphia,58.00%,630,630,1260,27,http://usciences.edu
Gustavus Adolphus College,67.80%,620,640,1260,27,http://gustavus.edu
Augustana College,59.00%,630,630,1260,27,http://augustana.edu
DePauw University,67.30%,630,630,1260,27,http://depauw.edu
Christendom College,88.80%,600,660,1260,26,http://christendom.edu
University of North Carolina Wilmington,61.20%,630,630,1260,25,http://uncw.edu
University of Central Florida,44.40%,626,633,1259,27,http://ucf.edu
Ithaca College,72.80%,620,635,1255,28,http://ithaca.edu
Indiana University Bloomington,77.90%,630,625,1255,28,http://iub.edu
Creighton University,71.40%,630,624,1254,27,http://creighton.edu
Michigan Technological University,74.50%,640,613,1253,27,http://mtu.edu
University of Colorado Boulder,81.50%,627,625,1252,28,http://colorado.edu
Butler University,67.80%,630,622,1252,27,http://butler.edu
Rollins College,66.60%,620,632,1252,27,http://rollins.edu
Hofstra University,68.50%,630,620,1250,28,http://hofstra.edu
Texas Christian University,47.10%,625,625,1250,28,http://tcu.edu
University of South Florida,42.70%,625,625,1250,27,http://usf.edu
Arizona State University,84.80%,630,620,1250,26,http://asu.edu
Aquinas College,51.90%,590,660,1250,24,http://aquinas.edu
Drake University,67.70%,620,628,1248,27,http://drake.edu
Wheaton College Norton,73.90%,605,640,1245,28,http://wheatoncollege.edu
University at Buffalo,55.90%,635,610,1245,27,http://buffalo.edu
University of Wisconsin Platteville,79.10%,630,615,1245,24,http://uwplatt.edu
Cedarville University,79.40%,610,632,1242,26,http://cedarville.edu
Loyola University Maryland,65.50%,620,620,1240,27,http://loyola.edu
Marquette University,81.70%,620,620,1240,27,http://marquette.edu
The University of Tennessee Knoxville,78.80%,620,620,1240,27,http://tennessee.edu
Covenant College,97.20%,600,640,1240,27,http://covenant.edu
The University of Kansas,93.40%,620,620,1240,26,http://ku.edu
Westmont College,62.40%,610,630,1240,25,http://westmont.edu
University of Nebraska at Lincoln,79.60%,620,620,1240,25,http://unl.edu
Marist College,46.20%,620,618,1238,27,http://marist.edu
University of Massachusetts Lowell,71.70%,630,608,1238,27,http://uml.edu
Elon University,72.10%,620,618,1238,27,http://elon.edu
Temple University,60.00%,618,620,1238,27,http://temple.edu
University of Puget Sound,88.30%,610,627,1237,28,http://pugetsound.edu
Muhlenberg College,48.40%,610,627,1237,27,http://muhlenberg.edu
Auburn University,80.70%,620,615,1235,28,http://auburn.edu
Univeristy of Iowa,82.60%,625,610,1235,26,http://uiowa.edu
University of Dallas,61.00%,610,625,1235,26,http://udallas.edu
University of San Francisco,64.60%,620,613,1233,26,http://usfca.edu
Austin College,55.30%,610,622,1232,25,http://austincollege.edu
Saint Michael’s College,85.10%,610,621,1231,27,http://smcvt.edu
Willamette University,83.60%,620,610,1230,28,http://willamette.edu
Point Loma Nazarene University,68.90%,610,620,1230,27,http://pointloma.edu
Allegheny College,63.60%,610,620,1230,27,http://allegheny.edu
The Catholic University of America,83.70%,610,620,1230,27,http://cua.edu
Southeastern Bible College,100.00%,570,660,1230,26,http://sebc.edu
Seton Hall University,70.40%,615,615,1230,26,http://shu.edu
Mills College,86.70%,580,650,1230,26,http://mills.edu
Dordt College,75.40%,630,600,1230,25,http://dordt.edu
School of the Art Institute of Chicago,48.60%,610,620,1230,25,http://saic.edu
Ursinus College,70.90%,610,618,1228,26,http://ursinus.edu
Seattle University,75.60%,610,617,1227,27,http://seattleu.edu
Florida Institute of Technology,63.50%,630,597,1227,27,http://fit.edu
Southwestern University,45.00%,600,627,1227,26,http://southwestern.edu
Southwestern University,45.00%,600,627,1227,26,https://www.southwestern.edu/
SUNY College of Environmental Science and Forestry,61.40%,610,617,1227,26,http://esf.edu
Washington and Jefferson  College,82.40%,610,616,1226,26,http://washjeff.edu
University of California Riverside,57.00%,620,605,1225,27,http://ucr.edu
Belmont University,83.80%,600,625,1225,27,http://belmont.edu
Universty of Houston,65.00%,615,610,1225,25,http://uh.edu
Bryant University,75.70%,620,601,1221,27,http://bryant.edu
Knox College,74.20%,610,610,1220,27,http://knox.edu
Truman State University,65.30%,610,610,1220,27,http://truman.edu
Simmons College,60.40%,600,620,1220,27,http://simmons.edu
South Dakota School of Mines and Technology,84.50%,650,570,1220,27,http://sdsmt.edu
Saint Anselm College,76.60%,600,620,1220,26,http://anselm.edu
Wabash College,65.00%,620,600,1220,26,http://wabash.edu
King’s College,40.90%,590,630,1220,26,http://kings.edu
Iowa State University,92.10%,625,595,1220,25,http://iastate.edu
Naropa University,100.00%,610,610,1220,25,http://naropa.edu
Touro University California,70.50%,600,620,1220,25,http://tu.edu
Salisbury University,62.20%,610,610,1220,23,http://salisbury.edu
Lake Forest College,57.90%,610,609,1219,27,http://lakeforest.edu
Berry College,61.60%,600,618,1218,26,http://berry.edu
Stetson University,68.40%,600,617,1217,26,http://stetson.edu
Missouri University of Science and Technology,83.50%,640,576,1216,27,http://mst.edu
Loyola University Chicago,67.90%,600,615,1215,28,http://luc.edu
George Mason University,86.70%,605,610,1215,27,http://gmu.edu
San Diego State University,34.00%,610,605,1215,26,http://sdsu.edu
SUNY Geneseo University,64.80%,610,605,1215,26,http://geneseo.edu
Florida Southern College,50.20%,600,614,1214,26,http://flsouthern.edu
Duquesne University,71.80%,600,613,1213,27,http://duq.edu
Howard University,31.60%,593,620,1213,25,http://howard.edu
Drew University,69.20%,600,612,1212,27,http://drew.edu
Embry-Riddle Aeronautical University,65.50%,610,601,1211,25,http://erau.edu
Hope College,84.00%,600,610,1210,27,http://hope.edu
Cornell College,61.00%,600,610,1210,27,http://cornellcollege.edu
University of the Pacific,64.90%,610,600,1210,26,http://pacific.edu
Michigan State University,71.10%,610,600,1210,26,http://msu.edu
The University of Oklahoma,80.40%,605,605,1210,26,http://ou.edu
SUNY New Paltz,41.30%,600,610,1210,25,http://newpaltz.edu
University of Redlands,67.50%,590,620,1210,25,http://redlands.edu
University of Alabama at Birmingham,91.80%,605,605,1210,25,http://uab.edu
Saint Norbert College,77.70%,605,605,1210,25,http://snc.edu
Oglethorpe University,61.60%,590,620,1210,25,http://oglethorpe.edu
LeTourneau University,45.50%,610,600,1210,25,http://letu.edu
Montana Tech of the University of Montana,91.50%,620,590,1210,24,http://mtech.edu
Otterbein University,82.50%,600,610,1210,23,http://otterbein.edu
Maryland Institute College of Art,64.30%,600,608,1208,25,http://mica.edu
Agnes Scott College,70.40%,580,627,1207,26,http://agnesscott.edu
Saint Joseph’s University,76.30%,600,606,1206,26,http://sju.edu
James Madison University,71.10%,595,610,1205,26,http://jmu.edu
Christopher Newport University,67.80%,590,613,1203,26,http://cnu.edu
Messiah College,78.90%,600,602,1202,26,http://messiah.edu
Grove City College,92.90%,570,631,1201,27,http://gcc.edu
Whitman College,51.70%,600,600,1200,29,http://whitman.edu
John Brown University,75.80%,580,620,1200,27,http://jbu.edu
Ohio Northern University,66.10%,610,590,1200,26,http://onu.edu
Concordia College,65.10%,580,620,1200,26,http://cord.edu
Birmingham-Southern College,65.10%,590,610,1200,26,http://bsc.edu
Goucher College,79.20%,570,630,1200,25,http://goucher.edu
Coe College,56.20%,610,590,1200,25,http://coe.edu
Oklahoma City University,71.70%,590,610,1200,25,http://okcu.edu
Montana State University,82.90%,590,610,1200,25,http://montana.edu
University of Evansville,70.00%,600,600,1200,25,http://evansville.edu
Montana University System,82.90%,590,610,1200,25,http://mus.edu
Andrews University,57.70%,600,599,1199,25,http://andrews.edu
Georgia College,77.80%,590,608,1198,25,http://gcsu.edu
Milligan College,83.40%,600,598,1198,25,http://milligan.edu
Juniata College,70.20%,600,597,1197,30,http://juniata.edu
University of Arizona,84.40%,610,586,1196,25,http://arizona.edu
University of Arkansas,77.50%,590,605,1195,26,http://uark.edu
Bradley University,66.80%,600,595,1195,26,http://bradley.edu
Florida International University,57.50%,585,610,1195,26,http://fiu.edu
Oregon State University,80.60%,600,595,1195,25,http://oregonstate.edu
University of North Carolina Charlotte,67.20%,600,595,1195,24,http://uncc.edu
University of Kentucky,94.50%,590,600,1190,26,http://uky.edu
Drury University,73.00%,610,580,1190,26,http://drury.edu
The University of Louisville,72.90%,590,600,1190,26,http://louisville.edu
University of Missouri - Columbia,77.80%,590,600,1190,26,http://missouri.edu
The University of Scranton,75.80%,590,600,1190,25,http://scranton.edu
Saint Edward’s University,73.90%,570,620,1190,25,http://stedwards.edu
Whitworth University,90.80%,590,600,1190,25,http://whitworth.edu
Carroll College,71.50%,580,610,1190,25,http://carroll.edu
Salem College,59.80%,570,620,1190,24,http://salem.edu
Seattle Pacific University,90.90%,570,620,1190,24,http://spu.edu
University of North Carolina School of the Arts,38.20%,580,607,1187,25,http://uncsa.edu
Champlain College,75.40%,580,605,1185,25,http://champlain.edu
University of Oregon,83.40%,585,600,1185,25,http://uoregon.edu
Appalachian State University,76.80%,585,600,1185,25,http://appstate.edu
Nova Southeastern University,78.50%,585,600,1185,25,http://nova.edu
University of Alabama,59.10%,589,594,1183,27,http://ua.edu
Roger Williams University,82.30%,590,593,1183,26,http://rwu.edu
University of New Hampshire,76.80%,590,593,1183,25,http://unh.edu
Dallas Baptist University,88.10%,580,602,1182,22,http://dbu.edu
Louisiana State University,74.20%,590,590,1180,26,http://lsu.edu
Colorado State University,81.40%,585,595,1180,26,http://colostate.edu
State University of New Institute of Technology,64.80%,600,580,1180,26,http://sunyit.edu
Washington College,74.40%,580,600,1180,26,http://washcoll.edu
University of Dayton,72.00%,590,590,1180,26,http://udayton.edu
Harding University,67.90%,580,600,1180,26,http://harding.edu
Nazareth College,63.60%,590,590,1180,25,http://naz.edu
DePaul University,68.20%,585,595,1180,25,http://depaul.edu
Saint Mary’s College,81.60%,570,610,1180,25,http://saintmarys.edu
Elizabethtown College,74.00%,590,590,1180,25,http://etown.edu
Mississippi State University,73.40%,580,600,1180,25,http://mssstate.edu
Susquehanna University,73.20%,580,600,1180,25,http://susqu.edu
Saint Mary’s College of Maryland,80.10%,580,600,1180,25,http://smcm.edu
Warren Wilson College,83.80%,560,620,1180,25,http://warren-wilson.edu
Cogswell Polytechnical College,64.50%,600,580,1180,25,http://cogswell.edu
Simpson College,82.50%,590,590,1180,24,http://simpson.edu
Webster University,46.60%,590,590,1180,24,http://webster.edu
Christian Brothers University,56.00%,590,590,1180,24,http://cbu.edu
Carroll University,70.80%,590,590,1180,24,http://carrollu.edu
High Point University,76.90%,590,590,1180,24,http://highpoint.edu
Eckerd College,67.70%,580,600,1180,24,http://eckerd.edu
University at Albany,52.10%,590,590,1180,24,http://albany.edu
Maryville University,94.50%,590,590,1180,24,http://maryville.edu
University of Nevada Reno,88.20%,590,590,1180,23,http://unr.edu
Western Washington University,87.70%,580,599,1179,25,http://wwu.edu
The University of Rhode Island,72.30%,589,590,1179,25,http://uri.edu
Lebanon Valley College,78.20%,590,589,1179,25,http://lvc.edu
Union University,60.00%,580,598,1178,26,http://uu.edu
University of Hawaii at Manoa,58.40%,589,589,1178,24,http://hawaii.edu
Adelphi University,74.20%,590,586,1176,25,http://adelphi.edu
Gordon College,75.50%,580,595,1175,26,http://gordon.edu
Valparaiso University,89.30%,590,585,1175,26,http://valpo.edu
Sacred Heart University,60.50%,590,585,1175,25,http://sacredheart.edu
Kennesaw State University,57.90%,580,595,1175,24,http://kennesaw.edu
University of North Florida,72.30%,575,600,1175,23,http://unf.edu
University of Wisconsin La Crosse,78.20%,590,584,1174,25,http://uwlax.edu
University of North Carolina Asheville,82.20%,570,602,1172,25,http://unca.edu
University of Mary Washington,73.50%,570,602,1172,24,http://umw.edu
Manhattan College,74.50%,580,590,1170,26,http://manhattan.edu
Saint John’s University,73.10%,585,585,1170,26,http://stjohns.edu
Bellarmine University,85.80%,580,590,1170,25,http://bellarmine.edu
Benedictine College,92.80%,580,590,1170,25,http://benedictine.edu
"College of Saint Benedict, Saint John’s University",80.00%,590,580,1170,25,http://csbsju.edu
Purchase College,42.50%,570,600,1170,25,http://purchase.edu
Wagner College,69.80%,580,590,1170,25,http://wagner.edu
University of Tampa,48.70%,580,590,1170,25,http://ut.edu
Xavier University,73.10%,570,600,1170,25,http://xavier.edu
University of Missouri Kansas City,56.50%,650,520,1170,25,http://umkc.edu
Massachusetts College of Art and Design,70.70%,560,610,1170,24,http://massart.edu
California Lutheran University,71.50%,570,600,1170,24,http://callutheran.edu
North Dakota State University,91.60%,590,580,1170,24,http://ndsu.edu
Ohio University,78.30%,580,590,1170,24,http://ohio.edu
Pacific Lutheran University,79.80%,580,590,1170,24,http://plu.edu
Utah State University,89.10%,580,590,1170,24,http://usu.edu
Northland College,61.20%,570,600,1170,23,http://northland.edu
Hamline University,67.10%,570,600,1170,23,http://hamline.edu
Samford University,82.10%,570,598,1168,26,http://samford.edu
Oklahoma State University,73.80%,580,587,1167,25,http://okstate.edu
Brigham Young University Hawaii,44.80%,570,597,1167,24,http://byuh.edu
Endicott College,80.50%,580,587,1167,24,http://endicott.edu
Assumption College,81.10%,580,586,1166,26,http://assumption.edu
College of Charleston,79.30%,570,596,1166,25,http://cofc.edu
Luther College,65.10%,590,575,1165,26,http://luther.edu
Virginia Commonwealth University,77.10%,570,595,1165,25,http://vcu.edu
Capital University,68.70%,570,594,1164,24,http://capital.edu
University of Northwestern Saint Paul,90.30%,570,593,1163,24,http://unwsp.edu
Le Moyne College,64.00%,580,581,1161,25,http://lemoyne.edu
University of Montana,92.60%,570,591,1161,24,http://umt.edu
University of Wyoming,95.10%,580,580,1160,25,http://uwyo.edu
Lawrence Technological University,77.80%,590,570,1160,25,http://ltu.edu
Ohio Wesleyan University,71.40%,570,590,1160,25,http://owu.edu
The University of Mississippi,88.10%,575,585,1160,25,http://olemiss.edu
Saint Mary’s College,81.60%,570,590,1160,25,http://stmarys-ca.edu
Rockhurst University,72.50%,580,580,1160,25,http://rockhurst.edu
Campbell University,59.80%,570,590,1160,24,http://campbell.edu
Kansas State University,94.60%,580,580,1160,24,http://k-state.edu
Oklahoma Christian University,64.80%,580,580,1160,24,http://oc.edu
California College of the Arts,69.70%,570,590,1160,24,http://cca.edu
Louisiana Tech University,61.70%,580,580,1160,24,http://latech.edu
State University of New York at Oswego,53.60%,580,580,1160,24,http://oswego.edu
Western New England University,85.40%,580,580,1160,24,http://wne.edu
Hood College,71.40%,570,590,1160,24,http://hood.edu
Philadelphia University,64.00%,570,590,1160,24,http://philau.edu
New York Institute of Technology,70.70%,590,570,1160,24,http://nyit.edu
Florida Atlantic University,63.30%,570,590,1160,24,http://fau.edu
University of Texas Arlington,79.50%,580,580,1160,23,http://uta.edu
University of North Texas,71.30%,570,590,1160,23,http://unt.edu
Elmhurst College,70.50%,570,590,1160,23,http://elmhurst.edu
Northwest Missouri State University,79.20%,640,520,1160,22,http://nwmissouri.edu
University of Alaska Fairbanks,77.00%,580,579,1159,22,http://uaf.edu
Loyola University New Orleans,94.30%,560,597,1157,25,http://loyno.edu
Texas Tech University,70.70%,575,580,1155,25,http://ttu.edu
Spelman College,43.40%,560,595,1155,24,http://spelman.edu
University of South Florida Saint Petersburg,40.00%,565,590,1155,24,http://usfsp.edu
Hampden-Sydney College,59.00%,570,584,1154,24,http://hsc.edu
McDaniel College,85.00%,570,584,1154,24,http://mcdaniel.edu
University of Maine,92.30%,570,584,1154,24,http://umaine.edu
University of Detroit Mercy,83.00%,580,574,1154,24,http://udmercy.edu
The College of Saint Scholastica,66.20%,580,574,1154,23,http://css.edu
Goshen College,67.70%,550,603,1153,24,http://goshen.edu
Wisconsin Lutheran College,90.30%,570,582,1152,23,http://wlc.edu
University of South Dakota,85.80%,580,571,1151,23,http://usd.edu
The University of Findlay,73.00%,570,580,1150,24,http://findlay.edu
University of Wisconsin Eau Claire,86.00%,580,570,1150,24,http://uwec.edu
West Virginia University,81.60%,570,580,1150,24,http://wvu.edu
Murray State University,81.40%,580,570,1150,24,http://murraystate.edu
Ramapo College of New Jersey,57.40%,570,580,1150,24,http://ramapo.edu
Arcadia University,64.20%,560,590,1150,24,http://arcadia.edu
Prescott College,79.60%,550,600,1150,24,http://prescott.edu
Pacific University Oregon,79.00%,570,580,1150,24,http://pacificu.edu
Grand Valley State University,82.80%,570,580,1150,24,http://gvsu.edu
Ball State University,64.80%,570,580,1150,23,http://bsu.edu
George Fox University,78.30%,560,590,1150,23,http://georgefox.edu
Univeristy of New Mexico,51.60%,570,580,1150,22,http://unm.edu
Savannah College of Art and Design,72.70%,559,590,1149,24,http://scad.edu
Regis University,60.40%,570,579,1149,24,http://regis.edu
Principia College,91.00%,578,570,1148,24,http://principiacollege.edu
Chatham University,54.50%,560,587,1147,24,http://chatham.edu
Southern Illinois University Carbondale,72.00%,580,566,1146,24,http://siu.edu
Hanover College,79.30%,570,575,1145,25,http://hanover.edu
Ouachita Baptist University,63.60%,570,575,1145,25,http://obu.edu
Saint John Fisher College,65.00%,575,570,1145,24,http://sjfc.edu
San Jose State University,63.60%,580,565,1145,23,http://sjsu.edu
California State University Long Beach,31.20%,575,570,1145,23,http://csulb.edu
University of Colorado Colorado Springs,92.80%,570,575,1145,23,http://uccs.edu
University of Washington Bothell,79.40%,580,565,1145,23,http://uwb.edu
Saint Francis University,75.40%,570,575,1145,23,http://francis.edu
Wilkes University,74.80%,570,574,1144,24,http://wilkes.edu
Saint Mary’s University,75.00%,570,574,1144,23,http://stmarytx.edu
Roanoke College,72.50%,560,583,1143,25,http://roanoke.edu
Anderson University South Carolina,79.10%,560,581,1141,23,http://andersonuniversity.edu
The Master’s College,65.80%,560,581,1141,22,http://masters.edu
Pace University,75.90%,560,580,1140,25,http://pace.edu
Lyon College,64.30%,580,560,1140,25,http://lyon.edu
Centenary College of Louisiana,59.70%,570,570,1140,25,http://centenary.edu
State University of New York at Potsdam,64.30%,560,580,1140,25,http://potsdam.edu
Abilene Christian University,57.00%,560,580,1140,24,http://acu.edu
Roberts Wesleyan College,68.90%,570,570,1140,24,http://roberts.edu
Walla Walla University,86.00%,550,590,1140,24,http://wallawalla.edu
Freed-Hardeman University,96.30%,560,580,1140,24,http://fhu.edu
Missouri State University,84.00%,570,570,1140,24,http://missouristate.edu
Presbyterian College,63.00%,570,570,1140,24,http://presby.edu
Carthage College,67.80%,580,560,1140,24,http://carthage.edu
University of Missouri Saint Louis,75.90%,580,560,1140,24,http://umsl.edu
Randolph-Macon College,67.10%,560,580,1140,24,http://rmc.edu
Tennessee Technological University,64.40%,570,570,1140,24,http://tntech.edu
California State Polytechnic University Pomona,55.50%,575,565,1140,23,http://csupomona.edu
University of Louisiana Lafayette,55.30%,560,580,1140,23,http://louisiana.edu
University of Texas at Tyler,64.50%,570,570,1140,23,http://online.uttyler.edu/
University of Tennessee Martin,68.90%,570,570,1140,23,http://utm.edu
Eastern Connecticut State University,63.60%,560,580,1140,23,http://easternct.edu
Saint Mary’s University of Minnesota,91.50%,570,570,1140,23,http://smumn.edu
Newman University,63.80%,550,590,1140,23,http://newmanu.edu
Illinois State University,88.90%,570,570,1140,23,http://illinoisstate.edu
Fontbonne University,96.80%,570,570,1140,23,http://fontbonne.edu
Viterbo University,62.50%,570,570,1140,23,http://viterbo.edu
University of Northern Iowa,80.70%,570,570,1140,23,http://uni.edu
Saint Xavier University,83.00%,570,570,1140,23,http://scu.edu
Saint Ambrose University,60.60%,570,570,1140,23,http://sau.edu
Adrian College,56.30%,570,570,1140,23,http://adrian.edu
Middle Tennessee State University,93.50%,560,580,1140,23,http://mtsu.edu
University of Nebraska Omaha,70.80%,570,570,1140,23,http://unomaha.edu
Wichita State University,97.10%,580,560,1140,23,http://wichita.edu
Winona State University,66.50%,570,570,1140,23,http://winona.edu
University of New Orleans,56.60%,560,580,1140,23,http://uno.edu
The University of Akron,92.50%,560,580,1140,23,http://uakron.edu
Kent State University,87.50%,560,580,1140,23,http://kent.edu
Towson University,76.30%,560,580,1140,23,http://towson.edu
Southeastern Louisiana University,90.10%,570,570,1140,22,http://southeastern.edu
Crown College,56.20%,560,580,1140,22,http://crown.edu
Sullivan University,84.10%,550,590,1140,21,http://sullivan.edu
Baldwin Wallace University,74.20%,560,579,1139,24,http://bw.edu
Georgia Southern University,67.70%,559,580,1139,23,http://georgiasouthern.edu
Lesley University,75.70%,550,588,1138,25,http://lesley.edu
University of South Alabama,78.60%,560,577,1137,24,http://southalabama.edu
University of Tennessee Chattanooga,82.80%,560,577,1137,23,http://utc.edu
Asbury University,70.30%,550,585,1135,25,http://asbury.edu
Queens University of Charlotte,78.50%,560,575,1135,24,http://quinnipiac.edu
Queens University of Charlotte,78.50%,560,575,1135,24,http://queens.edu
Florida Gulf Coast University,64.90%,555,580,1135,23,http://fgcu.edu
University of Wisconsin Milwaukee,71.80%,565,570,1135,22,http://uwm.edu
University of Nevada Las Vegas,82.00%,565,570,1135,22,http://unlv.edu
The College of Idaho,49.20%,560,574,1134,23,http://collegeofidaho.edu
Saint Vincent College,68.40%,560,574,1134,23,http://stvincent.edu
Alma College,64.00%,560,574,1134,23,http://alma.edu
Wittenberg University,72.20%,540,593,1133,25,http://wittenberg.edu
Massachusetts Maritime Academy,89.10%,570,562,1132,23,http://maritime.edu
University of New Haven,83.90%,560,571,1131,23,http://newhaven.edu
Trine University,73.40%,570,560,1130,25,http://trine.edu
Indiana Wesleyan University,72.00%,550,580,1130,24,http://indwes.edu
SUNY Cortland,47.90%,570,560,1130,24,http://cortland.edu
Monmouth University,77.30%,560,570,1130,23,http://monmouth.edu
Western Carolina University,39.60%,560,570,1130,23,http://wcu.edu
Lancaster Bible College,57.00%,550,580,1130,23,http://lbc.edu
University of Toledo,93.70%,570,560,1130,23,http://utoledo.edu
Whittier College,75.90%,560,570,1130,23,http://whittier.edu
Westminster College,63.70%,580,550,1130,23,http://westminster.edu
Dominican University of California,75.50%,550,580,1130,23,http://dominican.edu
Westminster College - Missouri,63.70%,580,550,1130,23,http://westminster-mo.edu
Mount Vernon Nazarene University,76.70%,550,580,1130,23,http://mvnu.edu
Norwich University,65.70%,560,570,1130,23,http://norwich.edu
University of Massachusetts Boston,77.60%,570,560,1130,23,http://umb.edu
State University of New York at Plattsburgh,52.90%,560,570,1130,23,http://plattsburgh.edu
Northern Arizona University,82.60%,560,570,1130,23,http://nau.edu
California State University Fullerton,43.40%,565,565,1130,22,http://fullerton.edu
Wells College,79.70%,550,580,1130,22,http://wells.edu
Wright State University,96.80%,560,570,1130,22,http://wright.edu
Augsburg College,45.00%,540,590,1130,22,http://augsburg.edu
Saint Martin’s University,95.60%,560,570,1130,21,http://stmartin.edu
Albion College,68.20%,560,568,1128,23,http://albion.edu
DeSales University,73.80%,560,567,1127,26,http://desales.edu
Daemen College,49.40%,570,557,1127,24,http://daemen.edu
University of New England,80.70%,560,567,1127,24,http://une.edu
Long Island University Brooklyn,84.30%,570,557,1127,23,http://liu.edu
Geneva College,63.30%,560,567,1127,23,http://geneva.edu
West  Chester University,74.40%,560,566,1126,23,http://wcupa.edu
University of South Florida Sarasota-Manatee,39.00%,545,580,1125,25,http://usfsm.edu
Washington State University,75.80%,560,565,1125,23,http://wsu.edu
University of Texas at San Antonio,76.60%,555,570,1125,22,http://utsa.edu
Edgewood College,71.10%,570,554,1124,23,http://edgewood.edu
Berea College,38.20%,570,553,1123,25,http://berea.edu
Oakland Univeristy,84.40%,560,563,1123,24,http://oakland.edu
Southern Illinois University Edwardsville,87.40%,560,563,1123,24,http://siue.edu
Belhaven University,59.10%,550,573,1123,22,http://belhaven.edu
Lee University,83.10%,540,580,1120,25,http://leeuniversity.edu
University of Colorado Denver,63.60%,560,560,1120,24,http://ucdenver.edu
University of Illinois at Chicago,72.70%,560,560,1120,24,http://uic.edu
Robert Morris University Illinois,33.80%,560,560,1120,24,http://robertmorris.edu
Saint Bonaventure University,70.50%,560,560,1120,24,http://sbu.edu
Misericordia University,74.40%,560,560,1120,24,http://misericordia.edu
Olivet Nazarene University,66.20%,550,570,1120,24,http://olivet.edu
State University of New York at Oneonta,59.50%,560,560,1120,23,http://oneonta.edu
Southeast Missouri State University,83.70%,560,560,1120,23,http://semo.edu
Widener University,69.20%,560,560,1120,23,http://widener.edu
University of Montevallo,47.70%,560,560,1120,23,http://montevallo.edu
Mercyhurst University,75.20%,550,570,1120,22,http://mercyhurst.edu
Nicholls State University,88.40%,580,540,1120,22,http://nicholls.edu
University of the Arts,74.00%,540,580,1120,22,http://uarts.edu
Springfield College,64.20%,560,560,1120,22,http://springfieldcollege.edu
University of Houston Clear Lake,45.00%,550,570,1120,22,http://uhcl.edu
University of La Verne,50.90%,560,559,1119,23,http://laverne.edu
Manhattanville College,89.90%,560,559,1119,22,http://mville.edu
Portland State University,90.00%,550,569,1119,22,http://pdx.edu
The Citadel Military College of South Carolina,81.10%,560,558,1118,23,http://citadel.edu
Southern Utah University,75.80%,550,567,1117,23,http://suu.edu
Niagara University,84.20%,560,557,1117,23,http://niagara.edu
Columbia College Chicago,87.10%,540,577,1117,23,http://colum.edu
Eastern Mennonite University,59.20%,550,566,1116,26,http://emu.edu
University of Idaho,77.20%,550,566,1116,23,http://uidaho.edu
Robert Morris University,38.70%,555,560,1115,24,http://rmu.edu
Western Connecticut State University,79.20%,550,564,1114,22,http://wcsu.edu
University of Mary Hardin-Baylor,86.70%,550,564,1114,22,http://umhb.edu
D’Youville College,96.80%,560,553,1113,23,http://dyc.edu
Fort Lewis College,90.90%,550,563,1113,21,http://fortlewis.edu
Marian University Indianapolis,61.40%,560,551,1111,22,http://marian.edu
Trinity Christian College,80.20%,530,580,1110,25,http://trnty.edu
Wayne State,67.40%,550,560,1110,25,http://wayne.edu
Central College,64.30%,530,580,1110,24,http://central.edu
The Evergreen State College,95.20%,530,580,1110,24,http://evergreen.edu
Northern Kentucky University,89.30%,550,560,1110,23,http://nku.edu
University of Saint Francis,51.70%,570,540,1110,23,http://stfrancis.edu
University of West Florida,41.50%,540,570,1110,23,http://uwf.edu
Shenandoah University,83.20%,550,560,1110,23,http://su.edu
University of Wisconsin River Falls,75.10%,550,560,1110,23,http://uwrf.edu
Palm Beach Atlantic University,95.30%,540,570,1110,23,http://pba.edu
Marietta College,69.00%,550,560,1110,23,http://marietta.edu
Linfield College,81.00%,550,560,1110,23,http://linfield.edu
South Dakota State University,90.80%,570,540,1110,23,http://sdstate.edu
Baker Univeristy ,67.30%,570,540,1110,23,http://bakeru.edu
Boise State University,81.70%,550,560,1110,23,http://boisestate.edu
University of North Dakota,82.20%,570,540,1110,23,http://und.edu
Elmira College,82.20%,550,560,1110,23,http://elmira.edu
Brigham Young University Idaho,97.20%,545,565,1110,23,http://byui.edu
University of Central Missouri,83.90%,555,555,1110,22,http://ucmo.edu
Johnson University,98.00%,550,560,1110,22,http://johnsonu.edu
Washburn University,98.80%,555,555,1110,22,http://washburn.edu
Northern Illinois University,54.40%,555,555,1110,22,http://niu.edu
Gardner-Webb University,53.00%,550,560,1110,22,http://gardner-webb.edu
Bemidji State University,66.20%,555,555,1110,22,http://bemidjistate.edu
Minnesota State University Mankato,61.00%,555,555,1110,22,http://mnsu.edu
Park University,69.00%,555,555,1110,22,http://park.edu
University of Wisconsin Superior,73.70%,600,510,1110,22,http://uwsuper.edu
Lake Superior State University,90.00%,555,555,1110,22,http://lssu.edu
Pittsburg State University,87.20%,555,555,1110,22,http://pittstate.edu
Bryan College of Health Sciences,40.00%,555,555,1110,22,http://bryanhealth.com
Dominican University,63.80%,540,570,1110,22,http://dom.edu
Southwestern Oklahoma State Univeristy,90.80%,555,555,1110,22,http://swosu.edu
University of Arkansas – Fort Smith,56.30%,555,555,1110,22,http://uafs.edu
University of Wisconsin Green Bay,92.50%,555,555,1110,22,http://uwgb.edu
Maine Maritime Academy,78.60%,560,550,1110,22,http://mainemaritime.edu
University of Wisconsin Stout,86.00%,555,555,1110,22,https://www.uwstout.edu/
University of Wisconsin Oshkosh,67.80%,555,555,1110,22,http://uwosh.edu
Missouri Southern State  University,94.10%,555,555,1110,22,http://mssu.edu
Heidelberg University,76.00%,550,560,1110,22,http://heidelberg.edu
College for Creative Studies,45.60%,555,555,1110,22,http://collegeforcreativestudies.edu
Lincoln Memorial University,59.70%,550,560,1110,21,http://lmunet.edu
Mount Marty College,69.20%,555,555,1110,21,http://mtmc.edu
Iowa Wesleyan College,41.30%,560,550,1110,21,http://iwc.edu
Siena College,77.90%,580,529,1109,25,http://siena.edu
Marywood University,75.20%,550,559,1109,23,http://marywood.edu
University of North Georgia,64.00%,550,558,1108,25,http://ung.edu
The College of Saint Rose,87.30%,550,558,1108,23,http://strose.edu
Bowling Green State University,72.30%,550,558,1108,23,http://bgsu.edu
University of Sioux Falls,91.30%,550,558,1108,23,http://usioxfalls.edu
Coastal Carolina University,69.60%,550,556,1106,22,http://coastal.edu
North Greenville University,59.90%,570,535,1105,24,http://ngu.edu
East Carolina University,82.20%,550,555,1105,22,http://ecu.edu
Moravian College,76.00%,550,554,1104,24,http://moravian.edu
University of Illinois Springfield,52.80%,550,554,1104,24,http://uis.edu
Southwest Baptist University,70.60%,550,554,1104,22,http://sbuniv.edu
Southern Arkansas University Magnolia,68.80%,540,563,1103,22,http://saumag.edu
Worcester State University,77.80%,550,552,1102,24,http://worcester.edu
Southern Adventist University,94.80%,540,562,1102,23,http://southern.edu
Richard Stockton College,84.40%,550,552,1102,22,http://stockton.edu
Alfred University,62.70%,550,550,1100,24,http://alfred.edu
Grace College,78.50%,540,560,1100,24,http://grace.edu
Bryan College,54.30%,530,570,1100,23,http://bryan.edu
Rider University,69.70%,550,550,1100,23,http://rider.edu
Southern Virgina University,69.00%,545,555,1100,23,http://svu.edu
Oral Roberts University,93.30%,540,560,1100,23,http://oru.edu
Cleveland State University,88.10%,540,560,1100,22,http://csuohio.edu
The College at Brockport,53.30%,550,550,1100,22,http://brockport.edu
Indiana University – Purdue University Indianapolis,80.70%,550,550,1100,22,http://iupui.edu
Concordia University Texas,83.50%,550,550,1100,22,http://concordia.edu
University of Wisconsin Whitewater,83.20%,560,540,1100,22,http://uww.edu
North Park University,54.00%,550,550,1100,22,http://northpark.edu
York College of Pennsylvania,69.80%,550,550,1100,22,http://ycp.edu
William Jessup University,76.10%,530,570,1100,22,http://jessup.edu
Southern Oregon University,78.20%,530,570,1100,22,http://sou.edu
Arkansas Tech University,90.20%,560,540,1100,22,http://atu.edu
Unity College,88.70%,540,560,1100,22,http://unity.edu
Reinhardt University,90.00%,540,560,1100,21,http://reinhardt.edu
California State University San Marcos,58.40%,550,550,1100,20,http://csusm.edu
Loras College,92.70%,560,539,1099,23,http://loras.edu
Central Michigan University,68.80%,540,559,1099,23,http://cmich.edu
The University of Memphis,84.20%,530,568,1098,23,http://memphis.edu
Old Dominion University,87.00%,540,558,1098,22,http://odu.edu
Northern State University,88.40%,570,528,1098,21,http://northern.edu
Lewis University,53.80%,550,546,1096,23,http://lewisu.edu
Rowan University,74.30%,525,570,1095,24,http://rowan.edu
Texas State University,77.90%,540,555,1095,23,http://txstate.edu
Eastern University,68.40%,540,555,1095,21,http://eastern.edu
Western Kentucky University,97.20%,540,554,1094,23,http://wku.edu
University of Massachusetts Dartmouth,77.50%,550,543,1093,23,http://umassd.edu
Saginaw Valley State University,77.40%,540,552,1092,23,http://svsu.edu
University of Northern Colorado,90.80%,540,552,1092,22,http://unco.edu
Marymount Manhattan College,78.00%,550,541,1091,25,http://mmm.edu
Mount Saint Mary College,93.80%,540,551,1091,21,http://msmc.edu
William Carey University,93.00%,590,500,1090,25,http://wmcarey.edu
SUNY Fredonia,76.20%,540,550,1090,24,http://fredonia.edu
Georgia State University,57.40%,545,545,1090,24,http://gsu.edu
Walsh University,77.80%,540,550,1090,23,http://walsh.edu
University of Indianapolis,86.20%,540,550,1090,23,http://uindy.edu
Dakota State University,83.20%,550,540,1090,23,http://dsu.edu
Georgetown College,67.30%,540,550,1090,23,http://georgetowncollege.edu
Wartburg College,75.70%,550,540,1090,23,http://wartburg.edu
Ashland University,76.00%,550,540,1090,23,http://ashland.edu
Iona College,88.20%,540,550,1090,23,http://iona.edu
Bob Jones University,86.20%,530,560,1090,23,http://bju.edu
Western State Colorado University,89.00%,540,550,1090,22,http://western.edu
Rockford University,49.00%,540,550,1090,22,http://rockford.edu
McPherson College,77.10%,550,540,1090,22,http://mcpherson.edu
Benedictine University,65.30%,540,550,1090,22,http://ben.edu
Otis College of Art and Design,46.30%,550,540,1090,22,http://otis.edu
University of Nebraska at Kearney,81.70%,560,530,1090,22,http://unk.edu
University of Southern Indiana,94.60%,540,550,1090,22,http://usi.edu
Simpson University,52.20%,530,560,1090,21,http://simpsonu.edu
California Baptist University,77.10%,540,550,1090,21,http://calbaptist.edu
Wheeling Jesuit University,93.20%,540,550,1090,21,http://wju.edu
Fisk University,80.90%,530,560,1090,21,http://fisk.edu
Millersville University,78.00%,540,549,1089,23,http://millersville.edu
Farmingdale State College,46.10%,550,538,1088,22,http://farmingdale.edu
Huntingdon College,56.00%,540,548,1088,22,http://huntingdon.edu
Suffolk University,83.40%,540,546,1086,24,http://suffolk.edu
University of Mount Union,96.40%,540,546,1086,23,http://mountunion.edu
Slippery Rock University,71.50%,540,546,1086,22,http://sru.edu
Montclair State University,70.90%,540,546,1086,21,http://montclair.edu
Stephen F. Austin State University,65.40%,540,546,1086,21,http://sfasu.edu
Liberty University,55.50%,540,545,1085,24,http://liberty.edu
Randolph College,86.70%,530,555,1085,22,http://randolphcollege.edu
West Virginia Wesleyan College,71.00%,530,555,1085,22,http://wvwc.edu
Muskingum University,72.20%,540,544,1084,22,http://muskingum.edu
Fairleigh Dickinson University,87.50%,550,533,1083,23,http://fdu.edu
Lubbock Christian University,89.70%,530,553,1083,22,http://lcu.edu
Cornerstone University,67.40%,510,573,1083,22,http://cornerstone.edu
Piedmont College,59.60%,530,553,1083,22,http://piedmont.edu
University of North Carolina Greensboro,83.80%,530,551,1081,23,http://uncg.edu
University of Michigan-Flint,65.10%,530,551,1081,23,http://umflint.edu
Youngstown State University,67.80%,540,541,1081,22,http://ysu.edu
University of the Cumberlands,71.20%,540,540,1080,22,http://ucumberlands.edu
University of Alaska,80.00%,540,540,1080,22,http://alaska.edu
Evangel University,61.00%,520,560,1080,22,http://evangel.edu
Dakota Wesleyan University,73.30%,540,540,1080,22,http://dwu.edu
Troy University,90.00%,540,540,1080,22,http://troy.edu
Ursuline College,93.30%,530,550,1080,22,http://ursuline.edu
Indiana University – Purdue University Fort Wayne,90.90%,530,550,1080,22,http://ipfw.edu
Lindenwood University,88.10%,540,540,1080,22,http://lindenwood.edu
Sonoma State University,92.00%,530,550,1080,22,http://sonoma.edu
Concordia University Saint Paul,54.90%,540,540,1080,21,http://csp.edu
Saint Cloud State University,85.10%,540,540,1080,21,http://stcloudstate.edu
Missouri Valley College,53.70%,580,500,1080,21,http://moval.edu
Weber State University,100.00%,540,540,1080,21,http://weber.edu
University of Central Oklahoma,81.00%,540,540,1080,21,http://uco.edu
Lindsey Wilson College,91.60%,540,540,1080,21,http://lindsey.edu
Salem State University,71.70%,530,550,1080,21,http://salemstate.edu
Northeastern State University,97.00%,540,540,1080,21,http://nsuok.edu
Mount Saint Mary’s University,64.20%,530,550,1080,21,http://msmary.edu
Methodist University,62.90%,540,540,1080,21,http://methodist.edu
Fresno Pacific University,68.00%,530,550,1080,21,http://fresno.edu
Fort Hays State University,89.00%,540,540,1080,21,http://fhsu.edu
Black Hills State University,87.00%,540,540,1080,21,http://bhsu.edu
Southeastern Oklahoma State University,72.00%,540,540,1080,21,http://se.edu
Texas A&M University Corpus Christi,87.00%,530,550,1080,20,http://tamucc.edu
University of California Merced,72.00%,540,540,1080,20,http://ucmerced.edu
Valley Forge Christian College,53.20%,520,560,1080,19,http://vfcc.edu
Rocky Mountain College,58.40%,540,539,1079,23,http://rocky.edu
University of Hartford,80.90%,560,518,1078,24,http://hartford.edu
Western Michigan University,82.30%,530,548,1078,23,http://wmich.edu
Carson-Newman University,66.00%,530,548,1078,22,http://cn.edu
University of North Alabama,70.20%,520,558,1078,22,http://una.edu
West Texas A&M University,61.40%,540,538,1078,21,http://wtamu.edu
Culinary Institute of America,97.20%,530,547,1077,22,http://ciachef.edu
California State University Monterey Bay,58.50%,530,545,1075,20,http://csumb.edu
Judson University,75.20%,540,534,1074,22,http://judsonu.edu
La Salle University,81.20%,530,544,1074,22,http://lasalle.edu
Humboldt State University,75.10%,530,543,1073,21,http://humboldt.edu
Fitchburg State University,86.90%,540,532,1072,21,http://fitchburgstate.edu
Austin Peay State University,93.80%,520,551,1071,22,http://apsu.edu
Marymount California University,90.90%,530,541,1071,21,http://marymountcalifornia.edu
Marymount University,90.90%,530,541,1071,21,http://marymount.edu
The City University of New York,38.00%,560,510,1070,24,http://cuny.edu
University of Central Arkansas,91.10%,540,530,1070,24,http://uca.edu
Manchester University,59.30%,530,540,1070,24,http://manchester.edu
McKendree University,61.70%,530,540,1070,23,http://mckendree.edu
University of Southern Mississippi,98.50%,530,540,1070,23,http://usm.edu
Xavier University of Louisiana,64.10%,530,540,1070,23,http://xula.edu
University of the Ozarks,97.00%,530,540,1070,23,http://ozarks.edu
Concordia University Portland Oregon,53.80%,530,540,1070,22,http://cu-portland.edu
Midwestern State University,76.00%,530,540,1070,22,http://mwsu.edu
Schreiner University,90.80%,530,540,1070,22,http://schreiner.edu
University of Saint Mary,61.30%,530,540,1070,22,http://stmary.edu
Hannibal-LaGrange University,56.00%,510,560,1070,22,http://hlg.edu
Southern New Hampshire University,92.90%,530,540,1070,22,http://snhu.edu
Bridgewater State University,90.10%,530,540,1070,22,http://bridgew.edu
Malone University,69.70%,530,540,1070,22,http://malone.edu
Elms College,67.50%,540,530,1070,21,http://elms.edu
Lim College,83.50%,530,540,1070,21,http://limcollege.edu
Colorado Mesa University,81.70%,530,540,1070,21,http://coloradomesa.edu
Lander University,42.30%,530,540,1070,21,http://lander.edu
Texas A&M University Texarkana,64.70%,530,540,1070,21,http://tamut.edu
Johnson State College,86.00%,530,540,1070,21,http://jsc.edu
California State University Channel Islands,78.00%,530,540,1070,21,http://csuci.edu
University of Saint Joseph Connecticut,90.30%,520,550,1070,21,http://usj.edu
Plymouth State University,78.80%,530,540,1070,21,http://plymouth.edu
Texas Woman’s University,86.80%,530,540,1070,20,http://twu.edu
Montana State University Billings,100.00%,530,540,1070,20,http://msubillings.edu
Delaware Valley College,65.70%,530,539,1069,23,http://delval.edu
Hiram College,57.60%,530,538,1068,22,http://hiram.edu
Delta State University,85.00%,540,527,1067,21,http://deltastate.edu
John Carroll University,85.00%,530,536,1066,25,http://jcu.edu
Shepherd University,89.10%,530,536,1066,21,http://shepherd.edu
Auburn University at Montgomery,92.80%,530,536,1066,21,http://aum.edu
Kettering College,28.00%,565,500,1065,23,http://kc.edu
Sam Houston State University,83.40%,525,540,1065,21,http://shsu.edu
The University of Mount Olive,53.00%,510,555,1065,19,http://umo.edu
Bloomsburg University,73.30%,530,534,1064,22,http://bloomu.edu
Aurora University,81.20%,530,534,1064,21,http://aurora.edu
Union College,59.90%,510,553,1063,23,http://ucollege.edu
Regent University,84.30%,510,551,1061,22,http://regent.edu
Jacksonville State University,53.10%,520,540,1060,23,http://jsu.edu
East Tennessee State University,87.10%,540,520,1060,23,http://etsu.edu
University of Arkansas at Little Rock,59.00%,540,520,1060,23,http://ualr.edu
Minnesota State University Moorhead,60.30%,540,520,1060,23,http://mnstate.edu
Cedar Crest College,63.30%,520,540,1060,23,http://cedarcrest.edu
Mount Saint Joseph University,60.30%,520,540,1060,23,http://msj.edu
Flagler College,56.60%,490,570,1060,23,http://flagler.edu
Houston Baptist University,69.00%,560,500,1060,23,http://hbu.edu
Ferris State University,74.20%,520,540,1060,22,http://ferris.edu
Henderson State University,90.50%,530,530,1060,22,http://hsu.edu
Virginia Wesleyan College,70.90%,520,540,1060,22,http://vwc.edu
Emporia State University,82.80%,540,520,1060,22,http://emporia.edu
Wilson College,52.70%,510,550,1060,22,http://wilson.edu
Purdue University Calumet,97.00%,520,540,1060,22,http://purduecal.edu
Shorter University,61.00%,520,540,1060,21,http://shorter.edu
Valdosta State University,74.20%,520,540,1060,21,http://valdosta.edu
Texas A&M University Commerce,34.10%,520,540,1060,21,http://tamuc.edu
Notre Dame de Namur University,80.10%,520,540,1060,21,http://ndnu.edu
Wilmington College,84.00%,520,540,1060,21,http://wilmington.edu
Frostburg State University,72.30%,520,540,1060,20,http://frostburg.edu
Husson University,80.20%,520,540,1060,20,http://husson.edu
Indiana University Southeast,85.10%,520,540,1060,20,http://ius.edu
University of Montana Western,70.00%,520,540,1060,19,http://umwestern.edu
Bethel University,89.80%,520,538,1058,22,http://bethel.edu
Kutztown University,73.90%,520,538,1058,21,http://kutztown.edu
Morehouse College,74.40%,520,538,1058,21,http://morehouse.edu
San Francisco State University,71.80%,520,537,1057,21,http://sfsu.edu
Winthrop University,67.30%,510,546,1056,23,http://winthrop.edu
University of the Incarnate Word,87.90%,520,536,1056,20,http://uiw.edu
University of South Carolina Aiken,50.90%,520,536,1056,20,http://usca.edu
Chestnut Hill College,95.70%,520,535,1055,22,http://chc.edu
Bethel University Indiana,90.00%,535,520,1055,22,http://bethelcollege.edu
Marshall University,90.60%,500,554,1054,22,http://marshall.edu
Angelo State University,73.10%,520,533,1053,21,http://angelo.edu
Longwood University,91.80%,510,542,1052,21,http://longwood.edu
Mansfield University,91.80%,520,531,1051,20,http://mansfield.edu
Thomas Jefferson University,58.00%,570,480,1050,25,http://jefferson.edu
Green Mountain College,82.00%,545,505,1050,24,http://greenmtn.edu
Northern Michigan University,74.40%,510,540,1050,23,http://nmu.edu
Eastern Michigan University,72.90%,550,500,1050,22,http://emich.edu
Cumberland University,46.40%,520,530,1050,22,http://cumberland.edu
Framingham State University,73.30%,520,530,1050,21,http://framingham.edu
Alvernia University,74.50%,520,530,1050,21,http://alvernia.edu
Tarleton State University,74.40%,520,530,1050,21,http://tarleton.edu
Concordia College New York,78.00%,520,530,1050,21,http://concordia-ny.edu
Upper Iowa University,52.20%,520,530,1050,21,http://uiu.edu
Culver-Stockton College,46.40%,520,530,1050,21,http://culver.edu
King University,58.00%,510,540,1050,20,http://king.edu
Midway College,56.70%,520,530,1050,20,http://midway.edu
East  Central University,48.00%,530,520,1050,20,http://ecok.edu
Limestone College,44.20%,520,530,1050,20,http://limestone.edu
Montana State University – Northern,64.00%,510,540,1050,20,http://msun.edu
University of Texas of the Permian Basin,82.50%,520,530,1050,20,http://utpb.edu
Lynn University,84.60%,520,528,1048,21,http://lynn.edu
Rivier University,68.10%,520,524,1044,21,http://rivier.edu
Vanguard University,40.20%,510,533,1043,20,http://vanguard.edu
Eastern Oregon University,98.40%,520,522,1042,20,http://eou.edu
Lamar University,85.70%,510,531,1041,21,http://lamar.edu
Georgia South Western State University,67.50%,510,531,1041,21,http://gsw.edu
Radford University,74.60%,510,531,1041,20,http://radford.edu
University of Wisconsin Stevens Point,81.00%,510,530,1040,23,http://uwsp.edu
Saint Joseph’s College of Maine,88.10%,510,530,1040,22,http://sjcme.edu
Eastern Kentucky University,70.60%,510,530,1040,22,http://eku.edu
Idaho State University,99.90%,510,530,1040,22,http://isu.edu
East Texas Baptist University,54.50%,520,520,1040,21,http://etbu.edu
Keene State College,82.70%,510,530,1040,21,http://keene.edu
Indiana University Kokomo,80.00%,520,520,1040,21,http://indiana.edu
Chaminade University of Honolulu,90.80%,520,520,1040,21,http://chaminade.edu
Columbia International University,33.40%,510,530,1040,20,http://ciu.edu
Cameron University,100.00%,520,520,1040,20,http://cameron.edu
University of Texas at El Paso,100.00%,520,520,1040,20,http://utep.edu
Mayville State University,57.10%,520,520,1040,20,http://mayvillestate.edu
Paul Smith’s College,73.00%,520,520,1040,20,http://paulsmiths.edu
North Arkansas College,100.00%,520,520,1040,20,http://northark.edu
Western Oregon University,80.60%,510,530,1040,20,http://wou.edu
Dominican College,76.70%,520,520,1040,20,http://dc.edu
Shawnee State University,69.90%,510,530,1040,20,http://shawnee.edu
Keuka College,93.70%,520,520,1040,20,http://keuka.edu
Mount Aloysius College,60.90%,520,520,1040,20,http://mtaloy.edu
University of Texas Pan American,69.00%,530,510,1040,20,http://utpa.edu
Texas A&M University Kingsville,89.20%,520,520,1040,20,http://tamuk.edu
Castleton State College of Vermont,77.90%,510,530,1040,20,http://castleton.edu
University of  Baltimore,60.00%,510,530,1040,20,http://ubalt.edu
University of Charleston,64.50%,520,520,1040,20,http://ucwv.edu
Alverno College,67.10%,520,520,1040,19,http://alverno.edu
Rogers State University,84.20%,520,520,1040,18,http://rsu.edu
Lehman College,40.00%,510,530,1040,18,http://lehman.edu
La Roche College,96.60%,510,527,1037,21,http://laroche.edu
University of Advancing Technology,83.00%,510,525,1035,21,http://uat.edu
California State University Sacramento,63.90%,515,520,1035,19,http://csus.edu
California University of Pennsylvania,96.90%,510,524,1034,19,http://calu.edu
Clarion University,94.10%,507,526,1033,21,http://clarion.edu
Cardinal Stritch University,78.30%,530,503,1033,21,http://stritch.edu
New Mexico State University,63.80%,520,513,1033,21,http://nmsu.edu
Central Washington University,64.40%,510,521,1031,19,http://cwu.edu
Central Methodist University,62.60%,520,510,1030,23,http://centralmethodist.edu
Minot State University,50.10%,520,510,1030,22,http://minotstateu.edu
Tennessee Wesleyan College,57.70%,510,520,1030,22,http://twcnet.edu
Colorado State University-Pueblo,95.20%,510,520,1030,21,http://colostate-pueblo.edu
William Paterson University,92.50%,510,520,1030,21,http://wpunj.edu
Waldorf College,71.90%,510,520,1030,21,http://waldorf.edu
Southern Connecticut State University,63.50%,500,530,1030,20,http://southernct.edu
La Sierra University,49.20%,510,520,1030,20,http://lasierra.edu
University of South Carolina Upstate,56.00%,510,520,1030,20,http://uscupstate.edu
Indiana University South Bend,81.90%,510,520,1030,20,http://iusb.edu
Newberry College,81.90%,510,520,1030,20,http://newberry.edu
Kentucky Christian University,40.00%,520,510,1030,20,http://kcu.edu
Wheelock College,95.00%,500,530,1030,20,http://wheelock.edu
Lees McRae College,57.20%,510,520,1030,20,http://lmc.edu
New England College,99.90%,510,520,1030,20,http://nec.edu
Emmanuel College,22.00%,510,520,1030,20,http://emmanuel.edu
University of Virginia’s College at Wise,77.50%,500,530,1030,20,http://uvawise.edu
Sierra Nevada College,69.00%,520,510,1030,20,http://sierranevada.edu
California State University Northridge,50.60%,510,520,1030,19,http://csun.edu
Centenary College of New Jersey,88.00%,510,520,1030,18,http://centenarycollege.edu
McMurry University,43.40%,520,509,1029,20,http://mcm.edu
Curry College,92.70%,510,516,1026,21,http://curry.edu
Ohio Dominican University,75.40%,510,515,1025,21,http://ohiodominican.edu
Saint Leo University,84.10%,520,504,1024,23,http://saintleo.edu
Valley City State University,73.70%,520,504,1024,21,http://vcsu.edu
Lock Haven University,94.30%,510,512,1022,22,http://lhup.edu
University of Houston Downtown,83.20%,510,511,1021,19,http://uhd.edu
Arkansas State University,70.20%,530,490,1020,24,http://astate.edu
Fairmont State University,65.60%,500,520,1020,21,http://fairmontstate.edu
Western Illinois University,58.80%,510,510,1020,21,http://wiu.edu
Eastern Illinois University,46.90%,500,520,1020,21,http://eiu.edu
Howard Payne University,58.90%,500,520,1020,21,http://hputx.edu
Coker College,61.70%,500,520,1020,20,http://coker.edu
Northwestern Oklahoma State University,62.40%,510,510,1020,20,http://nwosu.edu
Indiana University East,64.90%,500,520,1020,20,http://iue.edu
University of South Carolina Beaufort,62.70%,500,520,1020,20,http://uscb.edu
Columbia College South Carolina,86.80%,500,520,1020,20,http://columbiasc.edu
Mount Saint Mary’s College,81.00%,500,520,1020,18,http://la.edu
Indiana State University,89.90%,500,518,1018,20,http://indstate.edu
Concordia University Nebraska,75.00%,500,517,1017,23,http://cune.edu
Shippensburg University,83.60%,530,487,1017,21,http://ship.edu
Georgian Court University,68.90%,500,517,1017,20,http://georgian.edu
Indiana University of Pennsylvania,93.20%,500,517,1017,19,http://iup.edu
Texas A&M International University,52.20%,500,517,1017,18,http://tamiu.edu
Oakland City University,49.70%,510,506,1016,19,http://oak.edu
Metropolitan State University of Denver,64.30%,500,515,1015,20,http://msudenver.edu
Georgia Gwinnett College,88.00%,500,512,1012,19,http://ggc.edu
Anderson University,65.30%,510,501,1011,22,http://anderson.edu
East Stroudsburg University,72.00%,500,511,1011,19,http://esu.edu
Hartwick College,88.60%,510,500,1010,24,http://hartwick.edu
Jacksonville University,89.90%,500,510,1010,23,http://ju.edu
Cazenovia College,92.40%,500,510,1010,22,http://cazenovia.edu
Tuskegee University,53.00%,510,500,1010,21,http://tuskegee.edu
Thiel College,61.50%,510,500,1010,20,http://thiel.edu
Edinboro University,99.30%,500,510,1010,20,http://edinboro.edu
California State Fresno ,57.50%,500,510,1010,19,http://fresnostate.edu
Webber International University,49.00%,500,510,1010,19,http://webber.edu
University of Science and Arts of Oklahoma,66.00%,510,500,1010,19,http://usao.edu
Southern University at New Orleans,37.20%,510,500,1010,19,http://subr.edu
Our Lady of the Lake University,91.30%,500,510,1010,19,http://ollusa.edu
Saint Andrews University,41.10%,510,500,1010,19,http://sapc.edu
Southwestern Christian University,77.00%,505,505,1010,19,http://swcu.edu
Northeastern Illinois University,71.00%,500,510,1010,19,http://neiu.edu
Pfeiffer University,66.00%,500,510,1010,19,http://pfeiffer.edu
Silver Lake College of the Holy Family,50.00%,500,510,1010,17,https://www.holyfamilycollege.edu
Felician College,79.40%,500,503,1003,19,http://felician.edu
University of North Carolina Pembroke,81.20%,500,501,1001,20,http://uncp.edu
Monmouth College,67.00%,480,520,1000,23,http://monmouthcollege.edu
Greenville University,47.60%,490,510,1000,22,http://greenville.edu
West Liberty University,72.10%,510,490,1000,21,http://westliberty.edu
Ohio Valley University,63.60%,510,490,1000,21,http://ovu.edu
Urbana University,65.00%,500,500,1000,20,http://urbana.edu
Tiffin University,69.20%,500,500,1000,20,http://tiffin.edu
Keystone College,92.00%,500,500,1000,20,http://keystone.edu
Indiana University Northwest,79.60%,500,500,1000,20,http://iun.edu
University of West Georgia,58.60%,470,530,1000,20,http://westga.edu
University of Maine Fort Kent,95.00%,490,510,1000,20,http://umfk.edu
Holy Family University,70.70%,490,510,1000,19,http://holyfamily.edu
Grand Canyon University,67.00%,500,500,1000,19,http://gcu.edu
California State University Stanislaus,85.80%,490,510,1000,19,http://csustan.edu
Rhode Island College,72.80%,490,510,1000,19,http://ric.edu
Dixie State University,100.00%,500,500,1000,19,http://dixie.edu
California State University San Bernardino,54.80%,500,500,1000,18,http://csusb.edu
Oakwood University,57.40%,480,520,1000,18,http://oakwood.edu
University of Maine at Presque Isle,91.60%,490,508,998,20,http://umpi.edu
Averett University,61.00%,500,495,995,19,http://averett.edu
Wayland Baptist University,98.00%,500,493,993,20,http://wbu.edu
California State University Bakersfield,100.00%,490,503,993,19,http://csub.edu
California State University East Bay,71.60%,490,502,992,19,http://csueastbay.edu
Carlow University,91.40%,480,510,990,22,http://carlow.edu
Southwest Minnesota State University,80.00%,490,500,990,21,http://smsu.edu
Central Baptist College,62.00%,470,520,990,21,http://cbc.edu
Nyack College,98.40%,490,500,990,20,http://nyack.edu
Francis Marion University,60.00%,490,500,990,20,http://fmarion.edu
Kean University,86.00%,490,500,990,20,http://kean.edu
Canton State University of New York,78.00%,495,495,990,19,http://canton.edu
University of Texas Brownsville,87.00%,510,480,990,19,http://utb.edu
Warner Pacific College,62.80%,480,510,990,18,http://warnerpacific.edu
The College of New Rochelle,68.40%,470,519,989,22,http://cnr.edu
California State University Los Angeles,41.50%,490,495,985,18,http://calstate.edu
Eastern New Mexico University,60.00%,480,500,980,20,http://enmu.edu
Eastern Washington University,63.50%,480,500,980,20,http://ewu.edu
Tennessee State University,51.80%,490,490,980,18,http://tnstate.edu
North Carolina Central University,38.20%,490,490,980,18,http://nccu.edu
University of Arkansas at Pine Bluff,46.70%,480,500,980,18,http://uapb.edu
Neumann University,96.30%,490,489,979,18,http://neumann.edu
Columbus State University,53.40%,480,498,978,21,http://columbusstate.edu
Concord University,90.20%,500,477,977,21,http://concord.edu
Adams State University,98.60%,480,495,975,20,http://adams.edu
West Virginia State University,97.60%,490,484,974,19,http://wvstateu.edu
Prairie View A&M University,74.30%,480,493,973,19,http://pvamu.edu
The Lincoln University,79.70%,480,493,973,18,http://lincoln.edu
Elizabeth City State University,59.40%,480,491,971,18,http://ecsu.edu
Defiance College,56.50%,490,480,970,20,http://defiance.edu
SUNY Cobleskill,94.00%,480,490,970,20,http://cobleskill.edu
Life University,99.30%,480,490,970,19,http://life.edu
North Carolina Wesleyan College,97.80%,480,490,970,19,http://ncwc.edu
Alcorn State University,78.60%,490,480,970,19,http://alcorn.edu
Five Towns College,62.30%,480,490,970,18,http://ftc.edu
Ashford University,100.00%,485,485,970,18,http://ashford.edu
Winston-Salem State University,54.00%,490,480,970,17,http://wssu.edu
New Jersey City University,95.90%,480,481,961,18,http://njcu.edu
Governors State University,37.80%,470,490,960,19,http://govst.edu
Clayton State University,48.00%,460,491,951,20,http://clayton.edu
Holy Names University,52.60%,470,480,950,20,http://hnu.edu
Kentucky State University,45.40%,470,480,950,19,http://kysu.edu
Warner University,41.00%,480,470,950,18,http://warner.edu
Norfolk State University,67.30%,470,480,950,18,http://nsu.edu
New Mexico Highlands University,100.00%,480,470,950,17,http://nmhu.edu
Mount Ida College,63.00%,470,480,950,17,http://mountida.edu
Coppin State University,53.50%,470,480,950,17,http://coppin.edu
Morrisville State College,71.90%,470,475,945,19,http://morrisville.edu
Albertus Magnus College,58.10%,460,480,940,24,http://albertus.edu
Morehead State University,79.60%,480,460,940,23,http://moreheadstate.edu
Ferrum College,73.30%,470,470,940,20,http://ferrum.edu
Barry University,85.10%,510,430,940,19,http://barry.edu
Savannah State University,82.60%,460,480,940,17,http://savannahstate.edu
Gallaudet University,57.10%,470,470,940,17,http://gallaudet.edu
Bowie State University,38.00%,460,480,940,17,http://bowiestate.edu
South Carolina State University,53.20%,460,480,940,16,http://scsu.edu
Middle Georgia State University,94.00%,460,475,935,19,http://mga.edu
Avila University,41.10%,490,440,930,22,http://avila.edu
Alabama A&M University,50.80%,470,460,930,18,http://aamu.edu
Jackson State University,68.90%,465,465,930,17,http://jsums.edu
Virginia Union University,57.30%,430,500,930,16,http://vuu.edu
Roosevelt University,69.50%,460,462,922,23,http://roosevelt.edu
Finlandia University,37.70%,470,450,920,21,http://finlandia.edu
Virginia State University,91.00%,450,470,920,17,http://vsu.edu
Delaware State University,45.20%,450,460,910,19,http://desu.edu
Texas Southern University,56.60%,450,460,910,17,http://tsu.edu
Chowan University,54.70%,440,470,910,16,http://chowan.edu
Wesley College,60.50%,470,430,900,18,http://wesley.edu
California State University Dominguez Hills,77.20%,440,460,900,18,http://csudh.edu
Cheyney University of Pennsylvania,46.00%,450,440,890,18,http://cheyney.edu
The LeMoyne-Owen College,100.00%,445,445,890,16,http://loc.edu
Langston University,53.80%,445,445,890,16,http://langston.edu
Harris-Stowe State University,55.70%,430,450,880,18,http://hssu.edu
Shaw University,52.50%,420,431,851,15,http://shawu.edu
University of Louisiana at Monroe,71.60%,440,410,850,23,http://ulm.edu
Paine College,32.00%,410,420,830,16,http://paine.edu
Hesston College,100.00%,400,430,830,15,http://hesston.edu
Bethune-Cookman University,54.30%,390,410,800,16,http://cookman.edu
Central State University,57.10%,390,410,800,15,http://centralstate.edu